1111111111111111
1000000010000001
1000000010000001
1000000010000001
1000000011111001
1002222000000001
1002222220000001
1000222220000001
1000222220000001
1000000000000001
1000000000000001
1111111111111111
